111111111111111111111111
111C11111111111111111111
111111111111111111111111
11E111111111111111111111
1111111P1111111111111111
11P111111111111111111111
111111111111111111111111
111111111111111111111111
