1111111111
1111P01111
1111C0E111
1111111111
